GGGGGGGGGGGGGGGGGGGGGGGGGGGGGGGGGGGGGGGGGGGGGGGGGGGGGGGGGGGG
GGSSSSSSSSSSSSSSSSSSSSSSSSSSSSSSSSSSSSSSSSSSSSSSSSSSSSSSSSGG
GGSWWWWWWWWWWSGSWWWWWWWWWWWWWWWWWWWWWWWWWWWWWWWWWWWWWWWWWSGG
GGSWWWWWWWWWWSGSWWWWWWWWWWWWWWWWWWWWWWWWWWWWWWWWWWWWWWWWWSGG
GGSWWWWWWWWWWSGSWWWWWWWWWWWWWWWWWWWWWWWWWWWWWWWWWWWWWWWWWSGG
GGSWWWWWWWWWWSGSWWWWWWWWWWWWWWWWWWWWWWWWWWWWWWWWWWWWWWWWWSGG
GGSWWWWWWWWWWSGSWWWWWWWWWWWWWWWWWWWWWWWWWWWWWWWWWWWWWWWWWSGG
GGSWWWWWWWWWWSGSWWWWWWWWWWWWWWWWWWWSSSWWWWWWWWWWWWWWWWWWWSGG
GGSWWWWWWWWWWSGSWWWWWWWWWWWWWWWWWWWSGSWWWWWWWWWWWWWWWWWWWSGG
GGSWWWWWWWWWWSGSWWWWWWWWWWWWWWWWWWWSGSWWWWWWWWWWWWWWWWWWWSGG
GGSWWWWWWWWWWSGSWWWWWWWWWWWWWWWWWWWSGSWWWWWWWWWWWWWWWWWWWSGG
GGSWWWWWWWWWWSSSWWWWWWWWWWWWWWWWWWWSGSWWWWWWWWWWWWWWWWWWWSGG
GGSWWWWWWWWWWWWWWWWWWWWWWWWWWWWWWWWSGSWWWWWWWWWWWWWWWWWWWSGG
GGSWWWWWWWWWWWWWWWWWWWWWWWWWWWWWWWWSGSWWWWWWWWWWWWWWWWWWWSGG
GGSWWWWWWWWWWWWWWWWWWWWWWWWWWWWWWWWSGSWWWWWWWWWWWWWWWWWWWSGG
GGSWWWWWWWWWWWWSSSSSSSSSSSSSSSSSSSSSGSSSSSSSSSWWWWWWWWWWWSGG
GGSWWWWWWWWWWWWSGGGGGGGGGGGGGGGGGGGGGGGGGGGGGSWWWWWWWWSSSSGG
GGSSSSSSSSSWWWWSSSSSSSSSSSGSSSSSSSSSSSSSSSSSSSWWWWWWWWSGGGGG
GGGGGGGGGGSWWWWWWWWWWWWWWSGSWWWWWWWWWWWWWWWWWWWWWWWWWWSSSSGG
GGSSSSSSSSSWWWWWWWWWWWWWWSGSWWWWWWWWWWWWWWWWWWWWWWWWWWWWWSGG
GGSWWWWWWWWWWWWWWWWWWWWWWSGSWWWWWWWWWWWWWWWWWWWWWWWWWWWWWSGG
GGSWWWWWWWWWWWWWWWWWWWWWWSGSWWWWWWWWWWWWWWWWWWWWWWWWWWWWWSGG
GGSWWWWWWWWWWWWWWWWWWWWWWSSSWWWWWWWWWWWWWWWWWWWWWWWWWWWWWSGG
GGSWWWWWWWWWWWWWWWWWWWWWWWWWWWWWWWWWWWWWWWWWWWWWWWWWWWWWWSGG
GGSWWWWWWWWWWWWWWWWWWWWWWWWWWWWWWWWWWWWWWWWWWWWWWWWWWWWWWSGG
GGSWWWWWWWWWWWWWWWWWWWWWWSSSWWWWWWWWWWWWWWWWWWWWWWWWWWWWWSGG
GGSWWWWWWWWWWWWWWWWWWWWWWSGSWWWWWWWWWWWWWWWWWWWWWWWWWWWWWSGG
GGSWWWWWWWWWWWWWWWWWWWWWWSGSWWWWWWWWWWWWWWWWWWWWWWWWWWWWWSGG
GGSWWWWWWWWWWWWWWWWWWWWWWSGSWWWWWWWWWWWWWWWWWWWWWWWWWWWWWSGG
GGSWWWWWWWWWWWWWWWWWWWWWWSGSWWWWWWWWWWWWWWWWWWWWWWWWWWWWWSGG
GGSWWWWWWWWWWWWWWWWWWWWWWSGSWWWWWWWWWWWWWWWWWWWWWWWWWWWWWSGG
GGSWWWWWWWWWWWWWWWWWWWWWWSGSWWWWWWWWWWWWWWWWWWWWWWWWWWWWWSGG
GGSSSSSSSSSSSSSSSSSSSSSSSSGSSSSSSSSSSSSSSSSSSSSSSSSSSSSSSSGG
GGGGGGGGGGGGGGGGGGGGGGGGGGGGGGGGGGGGGGGGGGGGGGGGGGGGGGGGGGGG