GGGGGGGGGGGGGGGGGGGGGGGGGGGGGGGGGGGGGGGGGGGGGGGGGGGGGGGGGGGG
GGSSSSSSSSSSSSSSSSSSSSSSSSSSSSSSSSSSSSSSSSSSSSSSSSSSSSSSSSGG
GGSWWWWWWWWWWWWSWWWWWWWWWWWWWWWWWWWWWWWWWWWWWWWWWWWWWWWWWSGG
GGSWWWWWWWWWWWWSWWWWWWWWWWWWWWWWWWWWWWWWWWWWWWWWWWWWWWWWWSGG
GGSWWWWWWWWWWWWSWWWWWWWWWWWWWWWWWWWWWWWWWWWWWWWWWWWWWWWWWSGG
GGSWWWWWWWWWWWWSWWWWWWWWWWWWWWWWWWWWWWWWWWWWWWWWWWWWWWWWWSGG
GGSWWWWWWWWWWWWSWWWWWWWWWWWWWWWWWWWWWWWWWWWWWWWWWWWWWWWWWSGG
GGSWWWWWWWWWWWWSWWWWWWWWWWWWWWWWWWWSWWWWWWWWWWWWWWWWWWWWWSGG
GGSWWWWWWWWWWWWSWWWWWWWWWWWWWWWWWWWSWWWWWWWWWWWWWWWWWWWWWSGG
GGSWWWWWWWWWWWWSWWWWWWWWWWWWWWWWWWWSWWWWWWWWWWWWWWWWWWWWWSGG
GGSWWWWWWWWWWWWSWWWWWWWWWWWWWWWWWWWSWWWWWWWWWWWWWWWWWWWWWSGG
GGSWWWWWWWWWWWWSWWWWWWWWWWWWWWWWWWWSWWWWWWWWWWWWWWWWWWWWWSGG
GGSWWWWWWWWWWWWSWWWWWWWWWWWWWWWWWWWSWWWWWWWWWWWWWWWWWWWWWSGG
GGSWWWWWWWWWWWWWWWWWWWWWWWWWWWWWWWWSWWWWWWWWWWWWWWWWWWWWWSGG
GGSWWWWWWWWWWWWWWWWWWWWWWWWWWWWWWWWSWWWWWWWWWWWWWWWWWWWWWSGG
GGSWWWWWWWWWWWWWWWWWWWWWWWWWWWWWWWWSWWWWWWWWWWWWWWWWWWWWWSGG
GGSWWWWWWWWWWWWWWWWWWWWWWWWWWWWWWWWSWWWWWWWWWWWWWWWWWWWWWSGG
GGSSSSSSSSSSSSSSSSSSSSSSSSSSSSSSSSSSSSSSSSSSSSWWWWWWWWWWWSGG
GGSWWWWWWWWWWWWWWWWWWWWWWSWWWWWWWWWWWWWWWWWWWWWWWWWWWWWWWSGG
GGSWWWWWWWWWWWWWWWWWWWWWWSWWWWWWWWWWWWWWWWWWWWWWWWWWWWWWWSGG
GGSWWWWWWWWWWWWWWWWWWWWWWSWWWWWWWWWWWWWWWWWWWWWWWWWWWWWWWSGG
GGSWWWWWWWWWWWWWWWWWWWWWWSWWWWWWWWWWWWWWWWWWWWWWWWWWWWWWWSGG
GGSWWWWWWWWWWWWWWWWWWWWWWSWWWWWWWWWWWWWWWWWWWWWWWWWWWWWWWSGG
GGSWWWWWWWWWWWWWWWWWWWWWWSWWWWWWWWWWWWWWWWWWWWWWWWWWWWWWWSGG
GGSWWWWWWWWWWWWWWWWWWWWWWSWWWWWWWWWWWWWWWWWWWWWWWWWWWWWWWSGG
GGSWWWWWWWWWWWWWWWWWWWWWWSWWWWWWWWWWWWWWWWWWWWWWWWWWWWWWWSGG
GGSWWWWWWWWWWWWWWWWWWWWWWSWWWWWWWWWWWWWWWWWWWWWWWWWWWWWWWSGG
GGSWWWWWWWWWWWWWWWWWWWWWWWWWWWWWWWWWWWWWWWWWWWWWWWWWWWWWWSGG
GGSWWWWWWWWWWWWWWWWWWWWWWWWWWWWWWWWWWWWWWWWWWWWWWWWWWWWWWSGG
GGSWWWWWWWWWWWWWWWWWWWWWWWWWWWWWWWWWWWWWWWWWWWWWWWWWWWWWWSGG
GGSWWWWWWWWWWWWWWWWWWWWWWSWWWWWWWWWWWWWWWWWWWWWWWWWWWWWWWSGG
GGSWWWWWWWWWWWWWWWWWWWWWWSWWWWWWWWWWWWWWWWWWWWWWWWWWWWWWWSGG
GGSSSSSSSSSSSSSSSSSSSSSSSSSSSSSSSSSSSSSSSSSSSSSSSSSSSSSSSSGG
GGGGGGGGGGGGGGGGGGGGGGGGGGGGGGGGGGGGGGGGGGGGGGGGGGGGGGGGGGGG
