GGGGGGGGGGGGGGGGGGGGGGGGGGGGGGGGGGGGGGGGGGGGGGGGGGGGGGGGGGGG
GGSSSSSSSSSSSSSSSSSSSSSSSSSSSSSSSSSSSSSSSSSSSSSSSSSSSSSSSSGG
GGSWWWWWWWWWWWWWWWWWWWWWWWWWWWWWWWWWWWWWWWWWWWWWWWWWWWWWWSGG
GGSWWWWWWWWWWWWWWWWWWWWWWWWWWWWWWWWWWWWWWWWWWWWWWWWWWWWWWSGG
GGSWWWWWWWWWWWWWWWWWWWWWWWWWWWWWWWWWWWWWWWWWWWWWWWWWWWWWWSGG
GGSSSSWWWWSSSSSSSSSSSSSSSSSWWWWWWWWWWWWWWWWWWWWWWWWWWWWWWSGG
GGGGGSWWWWSGGGGGGGGGGGGGGGSWWWWWWWWWWWWWWWWWWWWWWWWWWWWWWSGG
GGSSSSWWWWSSSSGSSSSSSSSSSSSWWWWWWWWSSSWWWWWWWWWWWWWWWWWWWSGG
GGSWWWWWWWWWWSGSWWWWWWWWWWWWWWWWWWWSGSWWWWWWWWWWWWWWWWWWWSGG
GGSWWWWWWWWWWSGSWWWWWWWWWWWWWWWWWWWSGSWWWWWWWWWWWWWWWWWWWSGG
GGSWWWWWWWWWWSGSWWWWWWWWWWWWWWWWWWWSGSWWWWWWWWWWWWWWWWWWWSGG
GGSWWWWWWWWWWSSSWWWWWWWWWWWWWWWWWWWSGSWWWWWWWWWWWWWWWWWWWSGG
GGSWWWWWWWWWWWWWWWWWWWWWWWWWWWWWWWWSGSWWWWWWWWWWWWWWWWWWWSGG
GGSWWWWWWWWWWWWWWWWWWWWWWWWWWWWWWWWSSSWWWWWWWWWWWWWWWWWWWSGG
GGSWWWWWWWWWWWWWWWWWWWWWWWWWWWWWWWWWWWWWWWWWWWWWWWWWWWWWWSGG
GGSWWWWWWWWWWWWWWWWWWWWWWWWWWWWWWWWWWWWWWWWWWWWWWWWWWWWWWSGG
GGSWWWWWWWWWWWWWWWWWWWWWWWWWWWWWWWWWWWWWWWWWWWWWWWWWWWSSSSGG
GGSWWWWWWWWSSSSSSWWWWWWWWSSSSSSSSSSSSSSSSWWWWWWWWWWWWWSGGGGG
GGSWWWWWWWWWWWWWSWWWWWWWWSGGGGGGGGGGGGGGSWWWWWWWWWWWWWSSSSGG
GGSSSSSWWWWWWWWWSWWWWWWWWSGSSSSSSSSSSSSSSWWWWWWWWWWWWWWWWSGG
GGSWWWWWWWWSSSSSSWWWWWWWWSGSWWWWWWWWWWWWWWWWWWWWWWWWWWWWWSGG
GGSWWWWWWWWWWWWWSWWWWWWWWSGSWWWWWWWWWWWWWWWWWWWWWWWWWWWWWSGG
GGSSSSSWWWWWWWWWSWWWWWWWWSSSWWWWWWWWWWWWWSSSSSSSSSSSSWWWWSGG
GGSWWWWWWWWWWWWWWWWWWWWWWWWWWWWWWWWWWWWWWSWWWWWWWWWWSWWWWSGG
GGSWWWWWWWWWWWWWWWWWWWWWWWWWWWWWWWWWWWWWWSWWWWWWWWWWSWWWWSGG
GGSWWWWWWWWWWWWWWWWWWWWWWWWWWWWWWWWWWWWWWSWWWWWSWWWWSWWWWSGG
GGSWWWWWWWWWWWWWWWWWWWWWWWWWWWWWWWWWWWWWWSWWWWWSWWWWSWWWWSGG
GGSWWWWWWWWWWWWWWWWWWWWWWWWWWWWWWWWWWWWWWSWWWWWSWWWWWWWWWSGG
GGSWWWWWWWWWWWWWWWWWWWWWWWWWWWWWWWWWWWWWWSWWWWWSWWWWWWWWWSGG
GGSWWWWWWWWWWWWWWWWWWWWWWWWWWWWWWWWWWWWWWSWWWWWSSSSSSSWWWSGG
GGSWWWWWWWWWWWWWWWWWWWWWWWWWWWWWWWWWWWWWWWWWWWWWWWWWWWWWWSGG
GGSWWWWWWWWWWWWWWWWWWWWWWWWWWWWWWWWWWWWWWWWWWWWWWWWWWWWWWSGG
GGSSSSSSSSSSSSSSSSSSSSSSSSGSSSSSSSSSSSSSSSSSSSSSSSSSSSSSSSGG
GGGGGGGGGGGGGGGGGGGGGGGGGGGGGGGGGGGGGGGGGGGGGGGGGGGGGGGGGGGG